00000000000000000000
00001111000000000000
00001111000000000000
00001111000000000000
00001111000000000000
00000000000000000000
00000000000000000000
00000000000000000000
00000000000000000000
00000000000000000000
00000000000011110000
00000000000011110000
00000000000011110000
00000000000011110000
00000000000000000000