00000000000001000000
00000000000001000000
11111110000001000000
00000000000001000000
00000000000001000000
00000010000001000000
00000010000001000000
00000010000001000000
00000010000001000000
00000010000001000000
00000010000001000000
00000010000000000000
00000010000000000000
00000010000001111111
00000010000000000000
00000010000000000000