11110000000000001111
10000000000000000001
10000000000000000001
10000000000000000001
00001111111111110000
00000000000000000000
00000000000000000000
00000000000000000000
00000000000000000000
00000000000000000000
00000000000000000000
00001111111111110000
10000000000000000001
10000000000000000001
10000000000000000001
11110000000000001111