11110000000000001111
10000000000000000001
10000000000000000001
10000000000000000001
00000001111110000000
00000000000000000000
00001000000000010000
00001000000000010000
00001000000000010000
00001000000000010000
00000000000000000000
00000001111110000000
10000000000000000001
10000000000000000001
10000000000000000001
11110000000000001111